XXXXXXXXXX
X-I-XX=X-X
X-X--X=--X
X------X-X
X-X=-X---X
X--=XX-X-X
X-X==X-X-X
X-XX---X-X
X===-X---X
X=======UX
XXXXXXXXXX
